#######
#R# # #
# # # #
#   # #
### # #
#G    #
#######
