#########
#R  # # #
### # # #
#   #   #
### ### #
#       #
####### #
#G      #
#########
