#######
#R    #
##### #
# # # #
# # # #
#G    #
#######
